1111111111111111111111111111111111
100000C000000000000000000000000001
10100101001000001010010K0000010101
10100100101010100010010K0000010101
1E000C00C00P00000K00010K0000000001
1111111111111111111111111111111111