1111111111111111111111111111111111
100000000000000E000000KKK000000001
1010010100100000101001000K00010101
1010010010101010001001000000010101
1E0P0C00C0000000K000000K0000000001
1111111111111111111111111111111111