111111
100C11
100111
1P0E11
111111