1111111111111111111111111111111111
100000C000000000000000000000000001
1010010100100000101001000000010101
1010010010101010001001000000010101
1E000C00C00P0000000001000000000001
1111111111111111111111111111111111