1111111111111
10010000000C1
1P00011101001
10C001E000001
1111111111111