1111111111
10000C0001
1CEP000001
1111111111