1111111111111111111111111111111111
100000000000000E000000000000000001
1010010100100000101001000000010101
1010010010101010001001000000010101
1E000C00C00P0000K00000000000000001
1111111111111111111111111111111111