1111111111111111111111111111111111
1E0000000000000C00000C000000000001
1010010100100000101001000000010101
1010010010101010P010010000000101C1
100000000C00C000000000000000000001
1111111111111111111111111111111111
