1111111111
10000C0001
1CE000P101
1111111111